LLLLLLLLLLLLLLL
LTTTTTTTTTTTTTL
LTTTTTTTTTTTTTL
LTTTTTTTTTTTTTL
LSTTTTTTTTTTTEL
LTTTTTTTTTTTTTL
LTTTTTTTTTTTTTL
LTTTTTTTTTTTTTL
LLLLLLLLLLLLLLL